15
11  1  9  5  0 19 14 19  1  0 15 15  1 13 15
12 19  3 11 17 16  2  5 16 16  7 19 11 11  9
 6  9 11  1  2 17  5 14 16  2 11 10 12 17 16
 4  3  0 14  5  5 14  5  7 12 18  1  3 13  5
 1  0  6 14 17  0 15  9  0 13 17  8  9  6 16
13 16 13 17  4  5  4  7 19  8  2 18 18  3  5
 5  4  7  9  8 16 14 19  0  1  9 12 10 16 13
 1 10 10 15 11  1 13  3  2  9  4 13 13  0 17
14  5  7 18  1  6 15 10 10 15 14  1  0 13 14
15  6 13 19  1 10  2 10  2  7 13  4  0  0 11
 9 14 10  0  0  9 19  1  8 13  5  3 16 12  5
14  6  9  3  0 18  2  9  6  8 13  3 16 12 16
 9  0 17 18 19  5  3 17  2 12  2 13 19 19 10
19  4  5  1 18 18 17 11 13  0  7 12  4 13  7
 3 16  4 13  9 13  9  4  1  0  0  5  1  9 16
