14
10 18 12 20  7 10 20 17 13  9 11  1  8 20
17  8  1  2 20  9  3 13 15  8 12  2  8 14
12 20 20 13  4  6 17  1 20 12 20 10  1 12
 8  9  1  3  5 14  3  6 10 19  2  2 17 13
19  4 20 18 14  1 17 17 10  9  2 10 11  2
 9  2  6 10 14 11 19  5  5 11 18 13 19  1
12 15  5 20  1 14 14  3 17 18 18 18  3 13
10  2 17  5 13  7  9  9  9 10 13  3  1 13
20  9 16  2  4  2  6 14 19 19  1  2  9  6
19 19  8 16 12 18 17  9 19 15  2  8  5 18
 8  3 17 12 18  4  3 14 11 17 19  2 20  1
 1 18  1 12  8  5  5 12 11  1 13 18  3 10
12 10  3 20 20 14 10 15 19 12  2  2  1  6
17  9  2  3 18 16  7  2  2 15 17 15 12 20
