16
14 11  7 14  2 14 20 10  6  6 16 18 18 17  1 14
 9  9 19 11 13  6 10 11  9  1  4 10 13  5 18  1
19 16 15 15 15  3  3 10  8 12  1 17 13 19  7 18
18 14 14 11 16 17  5 16 15  9 19  6 18 17 11  2
11 18 15 11 14  6 16 15  8  3 16  4  1 14  5  2
12 19 13  4 14 15 10  6 19  6  7 10 12 14 17  6
16 12 19  9  5 14 12 13  3  5  4  6  7 19 17  5
10  8 20  8  8  9  3  6  2 19 10  5  3 12 12  5
13  3 10  4 12 12 10 16 20 18 19  5 18  9 13 11
16  6 10  5 12 14  2 10 11  5  6  1 19  8  3  4
10 18 14 10  1 14  8 11  2 13 14 16  9  1  2 11
10  8 12  9 12  3 19  7  6 15 19  5 16 14 11 17
 3  1 12 17  1 12 20  4 19 14 20 18 11  6  7 11
 8 15  2  2 11 19 12 13  3  2 15  4  3  4 20 17
 9  5  7  2  5  1  2 17  7 18 15 13  5 16 17  1
 7 14 11  1  2 15 15  4 18  4 16 16  3  9  9  8
