10
 5  9 14 19  2  4 19 17 12 17
 7  7  8  8  2 14  1  0  2  7
 2 10 17  4 11 11  0  0 11 16
 0  4 14 16 17  6  6 19 11 13
11  0 16  3  1 11 14 13 14  4
 6 12  9 12  1 16  9 13 13  5
 3 17 19 10  9 18 15  4 18  8
 6 15 10 15  7 15 18 15 19 13
 5  7 16  1 13 15  4 14 19 17
 0 11  5  9 11  4 13  8  8 13
