16
 1 19  4  8  5 16  4 13 18  3  1 13  4  4  8  1
15  8  6 15 13 14 15  7  3 10 13  6 14  7  6  3
 6 10  6 20 17 19 14  2 10 12  7  1  5 19  6  3
 7  9  9  9  6  7 18  3 20 12 19 11 20  5  7  2
17 11 20 18  2 10 14  7  3 14  8  9 17 17 17 11
20  4 11  8  9  6 11 11  6 19  4  3 17 17  2  8
19 18  2 17  9  2 10  8  1  3 14  4  5  6  9  1
17 13 10  1 17 17  3 15  9  4 18 11 17 12  6 16
11  2  3 17 13  6 20 14  2 11  2  2 16 17  6  5
 3 15 16 19 11 12 10 12  4 14 10  1  5  6 18 10
14 13 17 14 11 11 14 19 16  8  5  3 11 19  8 11
12  7  3  9  2  9  4  8  7 19 13 19 13 18  7 19
12  5  2 16 14 13  2  5 19 12  1 12  9  8  3  8
12  1 13  9 11  2  5  5 19  4 17 20  4  9  6 10
19 18  8  4  2  3 14 19 18 19  7 20 15  8 11 19
 5  8 12 15  1 12  8 10  3  5 15 13 18  3  9 18
