15
11 14 15  3  1  6  6 14 11  0 16  7 15  7  6
10  4 12  1 19 11  7  2 12 17  7  2  4 13  5
18 17  2 15  2  3 15 17 14  0  6 12  2  7  5
10  5 16 14 19 12  6  8  2  1  3 11  4 11 12
 1 19  8 19  6 18 15  8  8  2  6 19 16 19  4
 8 16 19 16  1 14  9  2 19 16  3 17  3  3  0
16  7  2  3 10  4  3  3  7  7 10 12  5 11 17
 7 10  4  1  8  3  0  2 16  2  6 13 16  3  4
 3 17 14 18  5  2 19 12  1 19  2  4 19 11  8
19  0 15 17  4  8 12 16  6 11  6 17 11  1 11
 3  5  5 14 16  1  2 13  7 14  4  0 15 18 17
 7 13 11 15 15 12  8  2  7  2 19 10 14 10  1
 1 14  0  0 10  7  2 19  9  3  7 19 12  4 18
 2  6  0 16  9 13 11  8 19  9  2 10  3  5  8
 6 17  2 11  6 11  6  8  1 17  2 16 14 15 12
