15
 6  5 17 15 18  3 12  1  4  1 19  3 10 13 18
17  2  2 11 19 11  9 13  4 20  9  9  1 18 13
13  6 15 11 19 10  6 14 16  6 10  3  9  7  8
16 11  3 16  7 13  6  7 17  9  1  3 18  2 19
16 19  5  4  9  5 19 17  5  4  7 18 11  1 16
 5  1 17  3 11 12 20 18 16 20 20 12 10 17  2
 1  7 13  7  5 19  5 12  3  1  6 19 15  9  4
13 20 17 16 11 20 20 17 15 14  7  5  3 12  6
 2 12 20 10  8  1 20 12 18 16  9 17  2  5  1
20 20  4 17  4  9  2  4 18 12  6  9  2  7 10
 2 17  7 17  4  3  6 13 11 17 16 12 11  1 11
15 17  1 19  5 18  1 13 20  1  9  4 10  2  5
 1  1 10 19  7 13 18  5 18 10 15 12 20  5  3
17 17 16  7 10  2  5  5 12 15 19  1  1 10  6
 7  8  8  3 20  1 15 20 20 14 13  5 10  8  9
