13
 3  6 10  9 15  3 11  3 12 16 17 19  7
 9  4  8 15 11  5  6 12  6 20 16 10  5
 5 19 15 19 12 17  2 15 10 14  8  1  8
 7 20  8 18  3 10 10  4  1  4  6  7 12
14 16  2  6 15 14 20  6  6 11  1  8  3
15 17  6 14 18 11 12  4 16  5 20 11 12
 8 15 15  9 17  3 18  5 11  4 17  8 20
19  3  4 19  6 10 10 15  8  1  4 20 11
16  6  9 14  3  2  1 20  4 15 18 18  6
 4  3  1  2  8 14  4  8  5  9 19  3 17
 5  1  1  1  4  3 20 17 15  8  5 17  2
 4 10 20 11  3 20  5  9 19  3  4  5  9
 3  7  7 17 13  2  6 12  6  1 10  9  8
